SO ./textures/redbrick.xpm
NO ./textures/wood.xpm
WE ./textures/greystone.xpm
EA ./textures/bluestone.xpm

C 84,0,179
F 0,211,117

 1111
 1001
 1001
 1N11 
 1111