SO ./textures/redbrick.xpm
NO ./textures/wood.xpm
WE ./textures/greystone.xpm
EA ./textures/bluestone.xpm

C 84,0,179
F 0,211,117

 11111 
 10001 
 10N01 
 10001 
 11111 
