SO ./textures/redbrick.xpm
NO ./textures/wood.xpm
WE ./textures/greystone.xpm
EA ./textures/bluestone.xpm

C 84,0,179
F 0,211,117

   11111   
  1000001  
  10N1001  
  1000001  
   11111  

