SO ./textures/redbrick.xpm
NO ./textures/wood.xpm
WE ./textures/greystone.xpm
EA ./textures/bluestone.xpm

C 84,171,179
F 240,211,117

111111111111111111111111
100000000000000000000001
100000000000000000000001
100000000000000000000001
100000000000000000000001
100000100000000000000001
100000100000000000010001
100000100000000000010001
100000111110000000010001
100000000000000000010001
100000000000000000000001
100000000000000000000001
100000000000000000000001
100000000000111111110001
100000000000100000010001
1000000000001000N0010001
100000000000100000010001
100000000000000000010001
100000000000000000010001
111110011111111111110001
100000000000000000000001
100000000000000000000001
100000000000000000000001
111111111111111111111111
