SO ./textures/brickwall.xpm
NO ./textures/Monke.xpm
WE ./textures/metalwall.xpm
EA ./textures/wolf.xpm

C 84,171,179
F 240,211,117
QQQQQQQQQQQQQQQQQQQQQQQQQQQQQQQQq


111111111111111111111111 111111111111
 10000000000100A000000001 100000000111
1111111111110000000000001000000000001
1001000000000000000000000000000000001
1111111111111111111111111111111111111

1111111111111111111111111111111111111
1111111110110000011100000000000000001
1000000000110000011101111111111100001
1111011111111101110000001000100000001
111101111111110111010100101010000001
11000000110101011100000010001000001
1000000000000000110000000000100001
100000000000000011010100100010001
11000001110101011111011110S01001
11110111 1110101 10111101000101
111111111111111111111111111111